####################
#..................#
#..................#
#..................#
#...##.............#
#..................#
#..................#
#..................#
#..........@.......#
#..................#
#.............##...#
#..................#
#..................#
#...........##.....#
#..................#
#..................#
#...####...........#
#..................#
#..................#
####################