##########
#........#
#......@.#
###.##.#.#
#........#
#...#..#.#
#..#....##
#...##...#
#........#
##########
