.#########
.#..@...#
.#..#..##
.#.....##
.#..###.#
.##.#...#
.#.#.#..#
.#...#.##
.##....##
.#####.##
